"filename", "language", "Java Properties", "Java", "XML", "comment", "blank", "total"
"d:\JAVA\book-note\nbactions.xml", "XML", 0, 0, 55, 0, 1, 56
"d:\JAVA\book-note\pom.xml", "XML", 0, 0, 13, 0, 0, 13
"d:\JAVA\book-note\src\main\java\com\mycompany\book\note\BST.java", "Java", 0, 173, 0, 111, 58, 342
"d:\JAVA\book-note\src\main\java\com\mycompany\book\note\Book.java", "Java", 0, 51, 0, 8, 17, 76
"d:\JAVA\book-note\src\main\java\com\mycompany\book\note\Home.java", "Java", 0, 568, 0, 63, 71, 702
"d:\JAVA\book-note\src\main\java\com\mycompany\book\note\ViewNote.java", "Java", 0, 80, 0, 29, 14, 123
"d:\JAVA\book-note\src\main\java\com\mycompany\book\note\notes.java", "Java", 0, 126, 0, 29, 23, 178
"d:\JAVA\book-note\target\classes\com\mycompany\book\note\BST$Node.class", "Java", 0, 27, 0, 0, 0, 27
"d:\JAVA\book-note\target\classes\com\mycompany\book\note\BST.class", "Java", 0, 30, 0, 0, 0, 30
"d:\JAVA\book-note\target\classes\com\mycompany\book\note\Book.class", "Java", 0, 18, 0, 0, 0, 18
"d:\JAVA\book-note\target\classes\com\mycompany\book\note\Home$1.class", "Java", 0, 11, 0, 0, 0, 11
"d:\JAVA\book-note\target\classes\com\mycompany\book\note\Home$10.class", "Java", 0, 11, 0, 0, 0, 11
"d:\JAVA\book-note\target\classes\com\mycompany\book\note\Home$11.class", "Java", 0, 10, 0, 0, 0, 10
"d:\JAVA\book-note\target\classes\com\mycompany\book\note\Home$12.class", "Java", 0, 10, 0, 0, 0, 10
"d:\JAVA\book-note\target\classes\com\mycompany\book\note\Home$13.class", "Java", 0, 10, 0, 0, 0, 10
"d:\JAVA\book-note\target\classes\com\mycompany\book\note\Home$14.class", "Java", 0, 10, 0, 0, 0, 10
"d:\JAVA\book-note\target\classes\com\mycompany\book\note\Home$15.class", "Java", 0, 10, 0, 0, 0, 10
"d:\JAVA\book-note\target\classes\com\mycompany\book\note\Home$16.class", "Java", 0, 11, 0, 0, 0, 11
"d:\JAVA\book-note\target\classes\com\mycompany\book\note\Home$2.class", "Java", 0, 18, 0, 0, 0, 18
"d:\JAVA\book-note\target\classes\com\mycompany\book\note\Home$3.class", "Java", 0, 14, 0, 0, 0, 14
"d:\JAVA\book-note\target\classes\com\mycompany\book\note\Home$4.class", "Java", 0, 14, 0, 0, 0, 14
"d:\JAVA\book-note\target\classes\com\mycompany\book\note\Home$5.class", "Java", 0, 10, 0, 0, 0, 10
"d:\JAVA\book-note\target\classes\com\mycompany\book\note\Home$6.class", "Java", 0, 14, 0, 0, 0, 14
"d:\JAVA\book-note\target\classes\com\mycompany\book\note\Home$7.class", "Java", 0, 10, 0, 0, 0, 10
"d:\JAVA\book-note\target\classes\com\mycompany\book\note\Home$8.class", "Java", 0, 10, 0, 0, 0, 10
"d:\JAVA\book-note\target\classes\com\mycompany\book\note\Home$9.class", "Java", 0, 6, 0, 0, 0, 6
"d:\JAVA\book-note\target\classes\com\mycompany\book\note\Home.class", "Java", 0, 206, 0, 0, 1, 207
"d:\JAVA\book-note\target\classes\com\mycompany\book\note\ViewNote$1.class", "Java", 0, 12, 0, 0, 0, 12
"d:\JAVA\book-note\target\classes\com\mycompany\book\note\ViewNote.class", "Java", 0, 52, 0, 10, 1, 63
"d:\JAVA\book-note\target\classes\com\mycompany\book\note\notes$1.class", "Java", 0, 12, 0, 0, 0, 12
"d:\JAVA\book-note\target\classes\com\mycompany\book\note\notes.class", "Java", 0, 70, 0, 7, 0, 77
"d:\JAVA\book-note\target\maven-archiver\pom.properties", "Java Properties", 3, 0, 0, 2, 1, 6
"Total", "-", 3, 1604, 68, 259, 187, 2121